Commerce_goods-transfer	Inheritance,Subframe
Making_arrangements	Inheritance
Releasing_from_custody	Inheritance
Cause_to_rot	Inheritance
Contrary_circumstances	Inheritance
Hunting_scenario	Inheritance
Summarizing	Inheritance
Thriving	Inheritance
Cause_to_fragment	Inheritance
Goal	Inheritance
Finish_game	Inheritance
Supporting	Inheritance
Strictness	Inheritance
Kinship	See_also
Seeking	Inheritance
Time_period_of_action	Inheritance
Adjusting	Inheritance
Cause_proliferation_in_number	Inheritance
Lose_possession	Inheritance,Subframe
Theft	Inheritance
Post_getting	Inheritance,Subframe
Fluidic_motion	Inheritance
Encounter	Inheritance
Predicament	Inheritance
Getting_up	Subframe
Key	Inheritance
Cause_harm	Inheritance
Be_translation_equivalent	See_also
Be_subset_of	Inheritance
Arriving	Inheritance,Subframe
Fastener	Inheritance
Lively_place	Inheritance
Military	Inheritance
Breaking_out_captive	Inheritance
Being_in_control	Inheritance
Scouring	Inheritance
Hostile_encounter	Inheritance
Remembering_to_do	See_also
Repel	Subframe
Presence	Inheritance,See_also
Perception_active	Inheritance
Becoming_attached	Inheritance
Rest	Inheritance
Government_institution	Inheritance
Short_selling	Inheritance
Impact	See_also
Being_employed	Subframe
Come_into_effect	Inheritance
Arrest	Inheritance,Subframe
Forming_relationships	Inheritance
Reshaping	Inheritance
Firing_point	Inheritance
Medical_conditions	Inheritance
Being_contained_within	Inheritance
Arithmetic_commutative	Inheritance
Cause_to_amalgamate	Inheritance
Come_together	Inheritance
Collaboration	Inheritance
Temporal_collocation	Inheritance,See_also
Undergo_transformation	Inheritance
Leaving_traces	Inheritance
Attempt_obtain_mineral_scenario	Inheritance
Intoxication	Inheritance
Clemency	Inheritance
Sound_movement	See_also
Political_locales	Inheritance
Bail_decision	Inheritance,Subframe
Name_conferral	Inheritance
Relational_political_locales	Inheritance
Plants	Inheritance
Taking_captive	Subframe
Surrendering_possession	Inheritance
Building_subparts	Subframe
Level_of_light	Inheritance
Age	Inheritance
Holding_off_on	See_also
Process_completed_state	Inheritance,Subframe
Labeling	Inheritance
Evading	Inheritance,See_also
Post_receiving	Inheritance,Subframe
Dynamism	Inheritance,See_also
Reserving	Inheritance
Notification_of_charges	See_also,Subframe
Dimension	See_also
Activity_done_state	Inheritance,Subframe
Becoming_dry	Inheritance
Aesthetics	Inheritance
Fleeing	Inheritance
Personal_success	Inheritance,See_also
Being_in_operation	Inheritance
Causation	Inheritance
Imprisonment	Inheritance
Sharpness	Inheritance
Reassuring	Inheritance
Connectors	Inheritance
Spatial_contact	Inheritance
Locative_relation	Inheritance
Choosing	Inheritance,See_also
Employment_continue	Subframe
Separating	Inheritance
Cause_fluidic_motion	Inheritance
Treating_and_mistreating	Inheritance
Attempt_suasion	Inheritance
Cause_to_end	Inheritance
Visitor_departure	Inheritance,Subframe
Position_on_a_scale	Inheritance
Giving	Inheritance,Subframe
Soaking	Inheritance
Assistance	Inheritance
Placing	Inheritance,See_also,Subframe
Cause_to_make_noise	Inheritance,See_also
Negation	Inheritance
Attaching	Inheritance
Bragging	Inheritance
Endangering	Inheritance
Opinion	See_also
Atonement	Inheritance
Activity_ongoing	Inheritance,Subframe
Education_teaching	Inheritance,See_also
Foreign_or_domestic_country	Inheritance
Memorization	Inheritance
Improvement_or_decline	Inheritance,See_also
Change_position_on_a_scale	Inheritance
Locale_by_ownership	Inheritance
Escaping	Inheritance
Creating	Inheritance
Emotions_by_possibility	Inheritance
Cause_emotion	Inheritance
Guest_and_host	Inheritance
Membership	Inheritance
Unemployment_rate	Inheritance
Arranging	Inheritance
Abundance	Inheritance
Being_awake	Subframe
Text_creation	Inheritance
Rate_description	Inheritance
Weapon	Inheritance
Proximity_image_schema	Inheritance
Intentional_deception	Inheritance
Standing_by	Inheritance
Duration_scenario	Inheritance
Active_substance	Inheritance
Quantity	Inheritance,See_also
Temporary_leave	Inheritance
People_by_jurisdiction	Inheritance
Passing_off	Inheritance
Artificiality	Inheritance
Supply	Inheritance
Visiting_scenario_departing	Inheritance,Subframe
Text	Inheritance
Part_piece	Inheritance
Level_of_force_resistance	Inheritance,See_also
Alignment_image_schema	Inheritance
Operating_a_system	Inheritance
Becoming_detached	Inheritance
Fining	Inheritance,See_also
Communication_manner	Inheritance
Body_parts	Inheritance
Change_resistance	Inheritance
See_through	Inheritance
Nuclear_process	Inheritance
Familiarity	Inheritance
Cause_to_be_dry	Inheritance
Intentional_traversing	Inheritance
Activity_prepare	Subframe
Deception_success	Inheritance
Being_attached	Inheritance
Amassing	Inheritance
Hit_or_miss	Inheritance,Subframe
Attention	Inheritance
Getting_underway	Subframe
Abounding_with	Inheritance,See_also
Killing	Inheritance
Judgment_communication	See_also
Measure_volume	Inheritance
Preference	Inheritance
Compatibility	Inheritance
Business_closure	Inheritance,See_also
Agree_or_refuse_to_act	Inheritance
People_by_origin	Inheritance
Region_with_portal	Inheritance
Gusto	Inheritance
Measure_mass	Inheritance
Come_down_with	Inheritance
Attempt_distant_interaction_scenario	Inheritance
Out_of_existence	Subframe
Manipulate_into_doing	Inheritance,Metaphor
Transition_to_state	Inheritance,See_also
Dominate_competitor	Inheritance
Operate_vehicle	Inheritance,See_also,Subframe
Cause_to_experience	Inheritance
Obscurity	Inheritance
Product_development	Subframe
Coming_to_believe	Inheritance
Praiseworthiness	Inheritance
Touring	Inheritance
Coincidence	Inheritance
Visit_host_departure	Inheritance,Subframe
Activity_pause	Inheritance,Subframe
Existence	Inheritance,Subframe
Trust	Inheritance
Trendiness	Inheritance
Suicide_attack	Inheritance
Hunting	Subframe
Victim_operated_IED	Inheritance
Fragmentation_scenario	Inheritance
Revenge	Inheritance
Cooking_creation	Inheritance,See_also
Body_decoration	Inheritance
Activity_ready_state	Inheritance,Subframe
Endeavor_failure	Inheritance
Post_giving	Inheritance,Subframe
Capacity	Inheritance
Contacting	Inheritance
Kidnapping	Inheritance
Undergoing	Inheritance
Exchange	Inheritance
Smuggling	Inheritance
Adjacency	Inheritance
Expectation	Inheritance,See_also
Detaching	Inheritance
Contrition	See_also
Cutting	Inheritance
Communication_noise	Inheritance
Losing	Inheritance
Using	Inheritance,See_also
Detonate_explosive	Inheritance
Emotions_by_stimulus	Inheritance
Relative_time	Inheritance
Cache	Inheritance
Compliance	Inheritance
Putting_out_fire	Subframe
Render_nonfunctional	Inheritance
Motion	Inheritance
Attempt_means	Inheritance
Filling	Inheritance,See_also
Posing_as	Inheritance
Process_resume	Inheritance,Subframe
Robbery	Inheritance
Arraignment	Inheritance,Subframe
Self_control	Inheritance
Birth_scenario	Inheritance,Subframe
Make_acquaintance	Inheritance
Control	Inheritance
Entourage	Inheritance
Mental_property	Inheritance
Similarity	Inheritance
Convoy	Inheritance
Burying	Inheritance
Thwarting	Inheritance
Renting_out	Inheritance
Authority	Inheritance
Locale_by_use	Inheritance
Activity_paused_state	Inheritance,Subframe
Waking_up	Inheritance,Subframe
Quitting_a_place	Inheritance,Subframe
Traversing	Inheritance
Sounds	See_also
Agriculture	Inheritance
Give_impression	Inheritance
Cause_motion	Inheritance,See_also
Duration_relation	Inheritance
Destiny	Inheritance
Cotheme	Inheritance
Complaining	Inheritance
Manipulate_into_shape	Inheritance
Corporal_punishment	Inheritance
Being_at_risk	Inheritance,See_also
Physical_artworks	Inheritance
Change_event_duration	Inheritance
Experience_bodily_harm	Inheritance
Drop_in_on	Inheritance,Subframe
Obligation_scenario	Inheritance
People_by_vocation	Inheritance
Location_of_light	Inheritance
Front_for	Inheritance
Process_stop	Inheritance,Subframe
Attitude_description	Inheritance
Practice	Inheritance
Military_operation	Inheritance
Mental_stimulus_exp_focus	Inheritance
Light_movement	See_also
Store	Inheritance
Being_questionable	Inheritance
Event_instance	Inheritance
Aiming	Inheritance,Subframe
Proliferating_in_number	Inheritance
Relation_between_individuals	Inheritance
Attempt	Inheritance,See_also
Locale_by_collocation	Inheritance
Rejuvenation	Inheritance
Gradable_attributes	Inheritance
Directional_locative_relation	Inheritance,See_also
Commerce_collect	Inheritance
Work	Inheritance
Non-gradable_proximity	Inheritance
Morality_evaluation	Inheritance
Besieging	Inheritance
Cause_to_move_in_place	Inheritance
Verification	Inheritance
Inhibit_movement	Inheritance,Subframe
Container_focused_removing	Inheritance
Passing	Inheritance,See_also
Duplication	Inheritance
Renting	Inheritance
Be_on_alert	Inheritance
Firefighting	Metaphor,Subframe
People	Inheritance
Money	Inheritance
Process_end	Inheritance,Subframe
People_along_political_spectrum	Inheritance
Being_relevant	Inheritance
Interior_profile_relation	Inheritance
Cure	Inheritance,See_also
Typicality	Inheritance
Reading_perception	Inheritance,See_also
Physical_entity	Inheritance
Temporary_transfer_scenario	Inheritance
Containing	Inheritance
Judgment_direct_address	Inheritance
Tasting	Inheritance
Distributed_position	Inheritance,See_also
Cause_change_of_position_on_a_scale	Inheritance
Conquering	Subframe
Ammunition	Inheritance
Committing_crime	Inheritance,Subframe
Biological_area	Inheritance
Be_in_agreement_on_assessment	Inheritance
Rising_to_a_challenge	Inheritance
Member_of_military	Inheritance
Response	Inheritance
Posture	Inheritance
Make_compromise	Inheritance
Having_commercial_agreement	Inheritance,Subframe
Omen	Inheritance
Noise_makers	Inheritance
Measure_duration	Inheritance
Execute_plan	Inheritance,See_also
Chaos	Inheritance
Departing	Inheritance,Subframe
Grooming	Inheritance
Accoutrements	Inheritance
Shoot_projectiles	Inheritance
Event_initial_state	Inheritance,Subframe
Objective_influence	Inheritance,See_also
Employing	Subframe
Hiding_objects	Inheritance
Infecting	Inheritance
Self_motion	Inheritance,See_also
Absorb_heat	Inheritance
Sensation	Inheritance
Friction	See_also
Information_display	Inheritance
Corroding_caused	Inheritance
Rewards_and_punishments	Inheritance
Forging	Inheritance
Aging	Inheritance
Visitor_arrival	Inheritance,Subframe
Preferred_alternative_scenario	Inheritance
Dying	Inheritance
Meet_specifications	Inheritance
Subversion	Inheritance
Relational_location	Inheritance
Fire_going_out	Subframe
Sociability	Inheritance
Social_connection	Inheritance
Damaging	Inheritance
Inclination	Inheritance
Assigned_location	Inheritance
Halt	Inheritance,Subframe
Food	Inheritance
Affirm_or_deny	Inheritance
Activity_stop	Inheritance,Subframe
Sound_level	Inheritance
Cause_temperature_change	Inheritance
Wholes_and_parts	Inheritance
Entering_of_plea	See_also,Subframe
Pre_lose_possession	Inheritance,Subframe
Arson	Inheritance
Indigenous_origin	Inheritance
Rotting	Inheritance
Certainty	Inheritance,See_also
Vehicle_subpart	Inheritance
Dispersal	Inheritance
Apply_heat	Inheritance
Medical_professionals	Inheritance
Change_of_temperature	Inheritance
Ingestion	Inheritance
Elusive_goal	Metaphor
Process_continue	Subframe
Social_event_collective	Inheritance
Cause_to_land	Subframe
Silencing	Inheritance
Run_risk	Inheritance
Erasing	Inheritance
Wealthiness	Inheritance
People_by_residence	Inheritance
Lending	Inheritance
Social_behavior_evaluation	Inheritance
Having_or_lacking_access	Inheritance
Architectural_part	Inheritance
Enforcing	Inheritance
Container_focused_placing	Inheritance
Disgraceful_situation	Inheritance
Shooting_scenario	Inheritance
Destroying	Inheritance
Research	Inheritance
Remembering_experience	See_also
Setting_fire	Inheritance
Vehicle	Inheritance
Quitting	Inheritance,Subframe
Precariousness	Inheritance
Improvised_explosive_device	Inheritance
Infrastructure	Inheritance
Being_rotted	Inheritance
Get_a_job	Inheritance,Subframe
Volubility	Inheritance
Records	Inheritance
Leadership	See_also
Suitability	Inheritance
Telling	Inheritance
History	Inheritance
Quarreling	Inheritance
People_by_religion	Inheritance
Roadways	Inheritance
Reveal_secret	Inheritance
Cause_impact	Inheritance,See_also
Organization	Inheritance
Cause_to_be_included	Inheritance
Biological_urge	Inheritance
Institutions	Inheritance
Employment_start	Subframe
Rope_manipulation	Inheritance
Fighting_activity	Inheritance
Pardon	Inheritance
Substance_by_phase	Subframe
Cause_expansion	Inheritance
Intentionally_affect	Inheritance
Invading	Inheritance,Subframe
Arithmetic_non-commutative	Inheritance
Identicality	Inheritance
Bounded_region	Inheritance
Resolve_problem	Inheritance
Temporary_stay	Inheritance
Mass_motion	Inheritance
Law_enforcement_agency	Inheritance
Visiting_scenario_stay	Subframe
Funding	Inheritance
Fire_break	Inheritance
Evaluative_comparison	Inheritance
Removing	Inheritance,See_also,Subframe
Proportion	Inheritance
Pre_receiving	Inheritance,Subframe
Tool_purpose	Inheritance
Socially_significant_history_scenario	Inheritance
Criminal_process	Subframe
Inspecting	Inheritance
Basis_for_attribute	Inheritance
Buildings	Inheritance
Shopping	Inheritance
Finish_competition	Inheritance,See_also,Subframe
Becoming	Inheritance
Event_endstate	Inheritance,Subframe
Social_interaction_evaluation	Inheritance,See_also
Frequency	Inheritance,See_also
Representative	Inheritance
Wearing	See_also
Bringing	See_also
Notability	Inheritance
Shaped_part	Inheritance
Sending	See_also
Emotions_success_or_failure	Inheritance
Temporary_group	Inheritance
Health_response	Inheritance
Borrowing	Inheritance
Process_initial_state	Inheritance,Subframe
Hit_target	Inheritance
Cause_to_be_sharp	Inheritance
Vehicle_landing	Inheritance
Change_tool	Inheritance
Team	Inheritance
Hospitality	Inheritance
Being_obligated	See_also
Limiting	Inheritance
Gradable_proximity	Inheritance
Change_of_leadership	Inheritance
Emergency	Inheritance
Natural_features	Inheritance
Desirability	Inheritance
Preserving	Inheritance
Change_operational_state	Inheritance
Visit_host_stay	Inheritance,Subframe
System_complexity	Inheritance
Eventive_affecting	Inheritance
Desiring	Inheritance
Emptying	Inheritance,See_also
Have_as_requirement	Inheritance
Death	Inheritance,Subframe
Completeness	Inheritance,See_also
Temperature	Inheritance
Measure_linear_extent	Inheritance
Risky_situation	Inheritance,See_also
Discussion	Inheritance
Ambient_temperature	Inheritance
Grinding	Inheritance
Hunting_success_or_failure	Subframe
Fall_asleep	Subframe
Simultaneity	Inheritance
Counterattack	Inheritance
Part_ordered_segments	Inheritance
Transportation_status	Inheritance
Punctual_perception	Inheritance
Activity_resume	Inheritance,Subframe
Degree	See_also
Have_visitor_over	Subframe
Releasing	Inheritance,Subframe
Pre_transfer	Inheritance,Subframe
Difficulty	Inheritance
Misdeed	Inheritance
Exchange_currency	Inheritance
Assemble	Inheritance
Circumscribed_existence	Inheritance
Attempt_action_scenario	Subframe
Motion_noise	Inheritance,See_also
Closure	Inheritance
Intoxicants	Inheritance
Activity_abandoned_state	Inheritance,Subframe
Luck	Inheritance
Transition_to_a_situation	Inheritance
Verdict	Inheritance,Subframe
Used_up	Inheritance
Cause_to_wake	Inheritance
Working_a_post	Inheritance
Create_physical_artwork	Inheritance
Cycle_of_life_and_death	Inheritance
Locale_by_event	Inheritance
Heralding	Inheritance
Planting	Subframe
Visitor_and_host	Inheritance
Time_vector	Inheritance,See_also
Biological_entity	Inheritance
Abandonment	Inheritance
Body_mark	Inheritance
Social_desirability	Inheritance
Expertise	Inheritance
Being_wet	Inheritance
Communication	Inheritance
Medical_instruments	Inheritance
Size	Inheritance
Sharing	Inheritance
Awareness	Inheritance
Assessing	Inheritance
Transfer	Inheritance,Subframe
Patrolling	Inheritance
Transition_to_a_quality	Inheritance
Chemical-sense_description	Inheritance
Confronting_problem	Inheritance
Prison	Inheritance
Receiving	Inheritance,Subframe
Achieving_first	Inheritance,Subframe
People_by_morality	Inheritance
Replacing	Inheritance,See_also
Part_orientational	Inheritance
Artifact	Inheritance
Scrutiny	See_also
Locale_closure	See_also
Being_active	Inheritance
Reading_aloud	Inheritance
Frugality	Inheritance
Firing	Inheritance,Subframe
Prevent_or_allow_possession	Inheritance
Rescuing	Inheritance
Avoiding	Inheritance
Commerce_pay	Inheritance
Change_of_phase	Subframe
Request_entity	Inheritance
Result_of_attempt_scenario	Subframe
Post_lose_possession	Inheritance,Subframe
Capability	Inheritance,See_also
Food_gathering	Subframe
Appointing	Inheritance
Exemplar	Inheritance
Undergo_change	Inheritance,See_also
Activity	Inheritance
Cause_to_perceive	Inheritance
Cause_to_continue	Inheritance
Chemical_potency	Inheritance
Dodging	Inheritance
Noncombatant	Inheritance
Just_found_out	Inheritance
Losing_someone	Inheritance
Price_per_unit	Inheritance
Conditional_scenario	Inheritance,See_also
Distant_operated_IED	Inheritance
Being_up_to_it	Inheritance
Body_description_holistic	Inheritance
Calendric_unit	Inheritance
Being_located	Inheritance
Usefulness	Inheritance
State_of_entity	Inheritance
Product_delivery	Inheritance
Prank	Inheritance
Clothing	Inheritance
Perception_experience	Inheritance,See_also
Annoyance	Inheritance
Visiting_scenario_arrival	Inheritance,Subframe
Emotion_active	Inheritance
Piracy	Inheritance
Setting_out	Inheritance,Subframe
Locale_by_characteristic_entity	Inheritance
Commerce_sell	Inheritance
Emotions	Inheritance
Relating_concepts	Inheritance
Visit_host	Inheritance
Transitive_action	Inheritance
Examination	Inheritance
Dead_or_alive	Inheritance,Subframe
Change_of_consistency	Inheritance
Scope	Inheritance
Preliminaries	Inheritance
Arithmetic	Inheritance
Daring	Inheritance
Abusing	Inheritance
Getting_vehicle_underway	Subframe
Visiting	Inheritance,Subframe
Trying_out	Inheritance
Downing	Inheritance
Cause_change	Inheritance
Becoming_aware	Inheritance
Likelihood	Inheritance
Travel	Inheritance
Process_start	Inheritance,See_also,Subframe
Building	Inheritance
Social_event_individuals	Inheritance
Court_examination	Subframe
Procreative_sex	Inheritance,Subframe
Commerce_buy	Inheritance
Idiosyncrasy	Inheritance,See_also
Taking	Inheritance
Ride_vehicle	See_also
Margin_of_resolution	Inheritance
Recording	Inheritance
Legal_rulings	Inheritance
Ceasing_to_be	Inheritance,Subframe
Actually_occurring_entity	Inheritance
Grasp	Inheritance
Intercepting	Inheritance
Talking_into	Inheritance
Cause_to_resume	Inheritance
Employment_end	Subframe
Manufacturing	Inheritance,Subframe
Pre_giving	Inheritance,Subframe
Topic	See_also
Hiring	Inheritance,Subframe
Taking_time	Inheritance
Emergency_fire	Inheritance,Subframe
Go_into_shape	Inheritance
Fear	Inheritance
Documents	Inheritance
Change_accessibility	Inheritance
Vocalizations	Inheritance
Becoming_a_member	Inheritance
Fire_emergency_scenario	Inheritance
System	Inheritance
Use_firearm	Inheritance
Activity_finish	Inheritance,Subframe
Bounded_entity	Inheritance
People_by_age	Inheritance
Commerce_money-transfer	Inheritance,Subframe
Visit_host_arrival	Inheritance,Subframe
Translating	Inheritance
Chatting	Inheritance
Cause_to_make_progress	Inheritance
Others_situation_as_stimulus	Inheritance
Getting	Inheritance,Subframe
Spatial_co-location	Inheritance
Motion_directional	Inheritance
Submitting_documents	Inheritance
Cause_change_of_phase	Inheritance
Warning	Inheritance
Manipulation	Inheritance
Bearing_arms	Inheritance
Attending	Inheritance
Judicial_body	Inheritance
Process_uncompleted_state	Inheritance,Subframe
Part_inner_outer	Inheritance
Substance	Inheritance
Ontogeny	Inheritance
Performers	Inheritance
Prominence	Inheritance
Historic_event	Inheritance,Subframe
Color_qualities	Inheritance
Location_on_path	Inheritance
Activity_start	Inheritance,Subframe
Receiving_scenario	Inheritance
Being_incarcerated	Inheritance
Gesture	Inheritance
Exercising	Inheritance
Artifact_subpart	Subframe
Emotions_of_mental_activity	Inheritance
Being_born	Inheritance,Subframe
Stinginess	Inheritance
Measurable_attributes	Inheritance
Surpassing	Inheritance
Event	Subframe
Body_description_part	Inheritance
Deception_end	Subframe
Process_stopped_state	Inheritance,Subframe
Scarcity	Inheritance
Proportional_quantity	See_also
Rape	Inheritance
Controller_object	Inheritance
Predicting	Inheritance
Sign_agreement	Inheritance
Coming_to_be	Inheritance,Subframe
Collocation_image_schema	Inheritance,See_also
Popularity	Inheritance
Duration_description	Inheritance
Cause_bodily_experience	Inheritance
Scrutinizing_for	Inheritance
Partiality	Inheritance
Criminal_investigation	Subframe
Extradition	Inheritance
Accuracy	Inheritance
Cause_change_of_consistency	Inheritance
Speed_description	Inheritance
Diversity	Inheritance
Measure_by_action	Inheritance
Expend_resource	Inheritance
Processing_materials	Inheritance
Inherent_purpose	Inheritance
Ingest_substance	Inheritance
Accompaniment	Inheritance
Execution	Inheritance
Precipitation	Inheritance,Subframe
Eventive_cognizer_affecting	Inheritance
Animals	Inheritance
Set_relation	Inheritance
Sentencing	Subframe
Being_dry	Inheritance
Part_edge	Inheritance
Level_of_force_exertion	Inheritance
Subsisting	Inheritance
Partitive	Inheritance
Attempt_obtain_food_scenario	Inheritance
Becoming_visible	Inheritance
Contact_image_schema	Inheritance
Seeking_to_achieve	Inheritance
Sequence	Inheritance
Mathematical_relationship	Inheritance
Interrupt_process	Inheritance
Imposing_obligation	Inheritance
Commercial_transaction	Inheritance,Subframe
Fullness	Inheritance
Deny_or_grant_permission	Metaphor
Earnings_and_losses	Inheritance
Rashness	Inheritance
Giving_scenario	Inheritance
Obviousness	Inheritance
Amalgamation	Inheritance
Setting_back_burn	Inheritance
Irregular_combatants	Inheritance
Process_pause	Inheritance,Subframe
Within_distance	Inheritance,See_also
Attack	Inheritance
Knot_creation	Inheritance
Sufficiency	Inheritance
Measure_area	Inheritance
Appellations	Inheritance
Indicating	Inheritance
Communication_response	Inheritance
Reparation	Inheritance
Mining	Inheritance
Explosion	Inheritance
Connecting_architecture	Inheritance
Being_operational	Inheritance
Race_descriptor	Inheritance
Post_transfer	Inheritance,Subframe
Intentionally_act	Inheritance
Rate_quantification	Inheritance
Change_posture	Inheritance
Retaining	Inheritance
Law	Inheritance
Cause_change_of_strength	Inheritance
Intentionally_create	Inheritance
Relational_natural_features	Inheritance
Judgment_of_intensity	Inheritance
Suasion	Inheritance
Cause_to_start	Inheritance
Gradable_artistic_quality	Inheritance
Correctness	Inheritance
Jury_deliberation	Subframe
Trial	Subframe
Biological_classification	Inheritance
Part_whole	Inheritance
Publishing	Inheritance
Addiction	Inheritance
Ineffability	Inheritance
Cause_to_be_wet	Inheritance
Immobilization	Inheritance
Surviving	Inheritance
Desirable_event	Inheritance
Color	Inheritance
Expected_location_of_person	Inheritance
Product_line	Inheritance
Pre_getting	Inheritance,Subframe
Gathering_up	Inheritance
Change_event_time	Inheritance
Sleep	Inheritance,Subframe
Attempting_and_resolving_scenario	Inheritance
Concessive	See_also
Fame	Inheritance
Social_event	Inheritance
Beat_opponent	Inheritance
Statement	None
Request	None
Terrorism	None
Giving_birth	None
Import_export_scenario	None
Meet_with	None
Communication_means	None
Detaining	None
Appeal	None
Birth	None
Guilt_or_innocence	None
Violence	None
Try_defendant	None
Take_place_of	None
Protest	None
Political_actions	None
Personal_relationship	None
Progress	None
Body_movement	None
Intentionally_create	None
Import_export	None
Purpose	None
Catastrophe	None